#Map Details
BBBOOOOOOOCCCOOOOBBB
BBBOOCOOOOFFCCOOOBBB
BBBOCCOOOOOFFCCCCBBB
OOOCCFOOOOOFFFCCCCOO
OOCCFFOOOOOOOOFFFCOO
OOCFFFOOOOCCOOFFFCOO
OOCFFFOOOOFFOOOFFCOO
OOOOOFOOOOOOOOOOOOOO
OOOOOOOOOOOOCCCCCCCC
OOOOOOOOOCCCCCCCCCCC
CCCCCOOOOCFFFFFFFFFC
CCCCCOOOOFCCFFFFFFFC
CFFFFOOOOFFFOOORRRRR
CFFFFOOOOOOOCCRRRRRR
CFFFFOOOOOOOFFRROOFC
OOOOOOOOOOOOORRROOFC
ORRRRRRPPRRRRRROOOFC
ORRRRRRPPRRRRRROOOFC
ORRWWWWGGWWWWWWWWOOO
ORRWVVVVVVVVVVVVWOOO